红/蓝开: start red/blue
赵信红开: start red on Xin
赵信红开吧？: Xin, start red?
赵信是红开的: Xin started red
反野: counter jg
四一分推: 41 split
开团，包括勾引开团，卖命开团等: initiate
先手开团: engage
强开团: hard engage
我们打反手: let them engage, we play defensivly
对面开，我们跑，止损，或者指开团者脱离战场: disengage
一波: end
参数：攻
击力: AD法强: 
AP蓝量: mana
攻速: AS
移速: MS
暴击几率: crit (chance)
暴击伤害: crit dmg
护甲: ar魔抗: mr
护甲穿透: ar pen(etration)
魔法穿透: ap pen
吸血: life steal
回复: regen 
强势(过强): OP / broken / imba
装备: item符文: rune
高地: base
高地们: base gate
水晶: inhib
基地: nexus
一塔: outer turret
二塔: inner turret
高地塔: inhib/base turret
门牙塔: nexus turret
泉水: fountain
小龙: drag/drake/DR
先锋: herald
大龙: baron/BR
蟹: crab
蛙: frogF6: birds
石头人: krugs
狼: wolves
经验: exp/xp
钱: gold
被动: passive
击杀和助攻: takedown
能量: energy
混伤: hybrid dmg
真伤: true dmg
持续伤害: dot dmg
持续效果: dot effect
泉水伤害/英雄自我伤害: pure dmg
发射体(能被亚索挡住的技能的飞行实体): projectile
攻击特效: on-hit effect
观战:OB/spectator mode
施法指示器: spell indicator怒气: fury
勇气(克烈): courage
蓄血(吸血鬼): bloodthirst
表情: emote
奶我: heal me
奶度/治疗: healing
魔免盾: spell shield
陷阱(包括盒子): trap
潜行(包括伪装和隐身，受到伤害会有微光，扫描能看到影子): stealth
伪装的(靠近会被看到，真眼也会看到): camouflaged
隐身的: invisible
消失(剑圣Q、劫R，还是受到持续伤害): vanished
技能类型:主动技能: active skill/spell
范围技能: AOE spell
范围伤害: AOE dmg
指向技能(以方向射出去，能空的): skillshot/direction-targeted spell
区域技能(如火男W，有范围的技能): ground-targeted spell
单体技能: single target spell
对地形施放的技能: terrain-targeted spell
锁定技能（锁定单位）: unit-targeted spell
锁定自我施放的: self-targeted
锁定友军施放的: ally-targeted
锁定敌军施放的: enemy-targeted
自动寻找目标的: auto-targeted
定位：近战: melee
远战: ranged
战士: bruiser/fighter/off-tank
重装战士: juggernaut
坦克: tank
刺客: assassin
射手: marksman
法师: mage
单挑怪: duelist
分推者: split-pusher
出护甲: get ar出肉: go tanky
坦度: tankiness
我来扛: I tank
我先抗塔: I tank turret 1st
剑魔强的一笔: aatrox OP af (as fuck)
水银细带很强: QSS is broken
成吨的伤害: tons of dmg
劫很肉: zed is tanky
劫没伤害，无视他: zed has no dmg, ignore him
蒙多很脆，集火他: mundo is squishy, focus him
节奏：
开局：帮我打红buff: leash red
多帮我打一下: hard leash plz
入侵野区: invade
上下换线: top and bot swap lanes
控线：
控线: freeze laneHbNz
控线(压出经验区或血线压制): zoning
推线: push
我得控他线，别推: i'ma freeze lane, dont push / i'ma zone him, dont push
帮我推: push 4 me
叫爹：
上路优势，帮他抓: top is winning, gank top
帮上路越: dive top
下路劣势，建议反蹲一哈: bot is losing, better counter gank
别来我这，你发育到6: dont come, u farm to 6
别越塔: dont dive
对线：
真眼: pink
小兵: minions/winions/creeps
血药: pot
补刀: cs
平A: aa / auto / basic atk
走A: stutter-stepping
骚扰: harass
上路不见了: top mia
线上的人: laner
对现阶段: laning phase
线霸: lane bully
持续压制他: keep bullying him
报技能：劫没大: zed no ult/R
有秒表: has stopwatch
有中亚: has zhonya / his zhonya is up / his zhonya's CDed
下路没召唤师技能: bot no sum
我tp好了，你们大龙逼团: my tp is up, u force them to fight around BR
中没净化: mid no cleanse / mid clenase is on CD / mid cleanse is not up
上路没水银: top no qss
射程不够: out of range
整体：
送塔: feed tower/turret
我是送死的: i got executed
斩杀技能: execution spell/skill
逃生: escape
我来了: OTW
滚雪球: snowball
续航: sustain
杀他伤害溢出浪费了: overkilled him, dmg wasted
艾翁很肥: Ivern is fed
塔: turret/tower
稳健点: play safe
集体苟到后期: turtling to late game
前期: early game
后期: late game
我不知道: idk
受到: ok/affirmative
别浪，会输: dont throw, we could lose
有眼: warded小心: care
小心机器人: care blitz
草丛埋伏: bait in bush
真眼勾引: pink bait
不要脸探草丛: dont face check
卖破绽，假装打不过，卖自己，勾引: bait
陷阱: trap
假装掉线: dc bait / pretend to dc
让我刷新大招: let me reset my ult
秒杀: instakill
回旋控: insec
让对面错误位移，比如绕视野和闪现进草丛: juke
躲技能: evade住中路(中性词): camp mid
住中路(变异): babysit mid偷家: backdoor
劫有爆发: zed has burst秒了他: nuke him
团战: team fight小心: care
撤: back保
我：peel 4 me
保努努: peel 4 nunu
选提莫: pick teemo/peemo
选counter位: counter pickcounter玩法: counterplay
青钢影去跟对面诺手去分推: camille counterpushes vs darius plz
偷偷摸到后排后面切入: flank
没视野: no sight
战争迷雾: fog/FoW
网络：我卡了: lagging掉
线: dc
掉包: packet dropping
我用笔记本在玩: playing on my laptop
控制：
控制: cc
硬控: hard cc
软控: soft cc
请接上控制：chain CCs plz
眩晕: stun
定身: root/snare
击开(德莱文E): knock aside
击退: knockback
击飞: knockup
勾: pull/hook
滞空，上述四种技能的统一状态: airbone
致盲: blind
恐惧: fear缚地(蛇女、炼金): ground
嘲讽: taunt
魅惑: charm
沉默: silence
击落(打断位移): knockdown
近视: nearsight
睡眠: sleep
减速: slow
凝滞(正在金身或被巴德R): stasis
压制: suppress
悬挂(能被完全解掉的击飞，如亚索娜美R): suspend
致残(减攻速): cripple
事前：
惩戒中路剑魔是版本最佳玩法: smite aatrox in mid is current metaADC
已经过时了赢不了: AD marksman is off meta, hard to win阵容: comp/team comp
全球流: global comp游戏愉快: GLHF人们: ppl (people)
这是个中文梗: it's a Chinese meme
排位: ranked
单排: solo Q
多排: duo Q
跟X排: duo with X
补位: fill
我是自动补位: I got autofill
秒退: dodge
秒选: instalock重开: remake
挂机: afk
挂机者: laver/AFKer
段位: rank (bronze silver gold plat diamond master challenger)
elo: 分
boosted: 找代练了
booster: 给人代练者
elo job: 代练(团战)
菜鸡互啄: fiesta/clown fiesta
削沙皇: nerf azir
不用谢: np
英雄：
mf: 赏金
raka: 星妈
LeBlank: 幺鸡
李星: Lee Star
放盾的司马英雄: shield bitch
斩杀技能的司马英雄: execution bitch
bug: 螳螂
chicken/chick: 黄鸡
tentacle lady: 俄洛伊
dick face: 卡萨丁
iron man: 金属大师
titan: 泰坦
yeti: 努努
hammer girl: 波比
深海哥: deep sea bro
跳跳虎: tigger
火男: fire boy/dude
ninja: 均衡三忍或劫
屁男: fart guy
石女: iron girl
老鼠: rat
血男: blood boy/guy
老头: old man
敖兴: Ao Shin
稻草人: scarecrow